//MAP CONVERTED BY dmm2tgm.py THIS HEADER COMMENT PREVENTS RECONVERSION, DO NOT REMOVE
"a" = (
/turf/floor{
	icon_state = "floor"
	},
/area/pod)
"b" = (
/turf/floor{
	dir = 4;
	icon_state = "floor"
	},
/area/pod)
"c" = (
/area/pod2)
"d" = (
/area/pod3)
"f" = (
/area/pod4)
"e" = (
/area/pod6)

(1,1,1) = {"
e
a
"}
(2,1,1) = {"
b
b
"}
(3,1,1) = {"
d
c
"}
(4,1,1) = {"
f
f
"}
