//MAP CONVERTED BY dmm2tgm.py THIS HEADER COMMENT PREVENTS RECONVERSION, DO NOT REMOVE
"a" = (
/turf/floor{
	icon_state = "floor";
	step_x = 1
	},
/area/pod)
"b" = (
/turf/floor{
	dir = 4;
	icon_state = "floor"
	},
/area/pod)
"d" = (
/area/pod3)

(1,1,1) = {"
a
a
"}
(2,1,1) = {"
b
b
"}
(3,1,1) = {"
d
d
"}